Fourth Room
0-3-4-5
3-2-2-2-3-0-0-0-0-0-3-2-2-2-3
2-1-1-1-2-2-2-2-2-2-2-1-1-1-2
3-1-1-1-1a-1-1-1-1-1-1a-1-1-1-3
0-2-1-1-1-1-1-1a-1-1-1-1-1-2-0
0-2-1-3-2-2-2-2-2-2-2-3-1-2-0
0-2-1-2-0-0-4-4-4-0-0-2-1-2-0
0-3-1-2-0-0-4-4-4-0-0-2-1-3-0
0-2-1-2-0-0-4-4-4-0-0-2-1-2-0
0-2-1-3-2-2-2-2-2-2-2-3-1-2-0
0-2-1-1-1-1-1-1a-1-1-1-1-1-2-0
3-1-1-1-1a-1-1-1-1-1-1a-1-1-1-3
2-1-1-1-2-2-2-2-2-2-2-1-1-1-2
3-2-2-2-3-0-0-0-0-0-3-2-2-2-3