Second Room
31-32-33-34
0-0-0-0-0-4-4-4-4-4-4-4-0-0-0-0-0-0
0-0-0-0-4-1-1-2-2-1-2-3-4-0-0-0-0-0
0-0-4-4-1-2a-3a-3-2-3-1-1-1-4-0-0-0-0
0-0-4-3-2a-2a-1-1-1-2-3-2-2-4-0-0-0-0
0-4-1-2a-3a-2-2-4-4-1-1-2-1-3-4-0-0-0
0-4-2a-3a-3-2-4-0-0-4-3-3-2-3-4-0-0-0
0-4-3-1-1-4-0-0-0-0-4-1-2-1-1-4-4-0
4-2-3-1-2-4-0-0-0-0-0-4-1-2-1-3-1-4
4-1-3-1-2-1-4-0-0-0-0-4-3-3-1-2-2-4
0-4-4-2-3-3-3-4-0-0-4-2-1-2-3-3-1-4
0-0-0-4-2-2-1-1-4-4-1-3-3-2-2-3-2-4
0-0-0-0-4-1-2-3-3-2-3-3-3-2-1-1-4-0
0-0-0-0-0-4-2-2-3-2-1-3-1-1-2-4-0-0
0-0-0-0-0-4-1-2-1-1-1-2-2-3-4-0-0-0
0-0-0-0-0-0-4-4-4-4-4-4-4-4-0-0-0-0