Second Room
24-25-3-4
3-4-4-3-3-0-0-0-0-0-4-4-3-3-3
3-3-3-4-4-0-0-0-0-0-4-3-3-4-3
4-1-2-3-4-3-3-4-4-3-4-3-3-1-4
3-2-2-3-0-0-4-1-1-0-0-3-4-4-4
4-4-3-4-1-2-3-2-1-2-2-4-3-3-4
3-3-3-3-2-1-1-0-2-1-1-3-4-3-3
3-3-4-3-0-0-2-2-2-0-0-3-3-4-3
4-4-3-3-2-1-1-1-2-1-2-3-4-4-4
0-0-4-3-3-2-1-4-3-1-1-3-3-3-4
3-4-3-3-3-4a-4-3a-4-3a-4-3-4-4-3
0-0-3-4a-3-3-3a-3-4a-4-3-3a-3-0-0
4-4-4-3-3-4-3-4-3-4-4-4-3-4-3