Fourth Room
30-34-10
0-1-1-1-1-1-0-0-0-1-1-1-1-1-0
1-1-1-1-1-1-1-1-1-1-1-1-1-1-1
1-1-2-2-2-2-2-1-2-2-2-2-2-1-1
0-1-1-1-1-1-1-3-1-1-1-1-1-1-0
0-0-2-1-3-3-3-2-3-3-3-1-2-0-0
0-0-2-2-0-0-0-2-0-0-0-2-2-0-0
0-0-2-1-3-3-3a-2a-3a-3-3-1-2-0-0
0-1-1-1-1-1-1-3-1-1-1-1-1-1-0
1-1-2-2-2-2a-2a-1a-2a-2a-2-2-2-1-1
1-1-1-1-1-1-1-1-1-1-1-1-1-1-1
0-1-1-1-1-1-0-0-0-1-1-1-1-1-0