Final Room
37-38-39-40
4-4-4-4-4-4-4-4-4-4-4-4-4-4-4-4-4
4-1-2-3-1-2-3-1-2-3-1-2-3-1-2-3-4
4-2-3-1-2-3-1-2-3-1-2-3-1-2-3-1-4
4-3-1-2-3-1-2-3-1-2-3-1-2-3-1-2-4
4-1-2-3-4-4-4-4-4-3-1-2-4-4-4-3-4
4-2-3-1-4-0-0-0-4-1-2-3-4-0-4-1-4
4-3-1-2-4-0-0-0-4-2-3-1-4-0-4-2-4
4-1-2-3-4-4-4-4-4-3-1-2-4-0-4-3-4
4-2-3-1-2-3-1-2-3-1-2-3-4-4-4-1-4
4-3-1a-2a-3a-1a-2a-3a-1a-2a-3a-1a-2a-3a-1a-2-4
4-1-2-3-1-2-3-1-2-3-1-2-3-1-2-3-4
4-4-4-4-4-4-4-4-4-4-4-4-4-4-4-4-4