Second Room
6-24-17
0-0-0-1-1-1-0-0-0-1-1-1-0-0-0
0-0-1-2-2-2-1-1-1-2-2-2-1-0-0
0-0-1-2a-3-2-2-2-2-2-3-2a-1-0-0
0-0-1-2a-3-3-3a-3a-3a-3-3-2a-1-0-0
0-0-1-2-2-2-3a-3a-3a-2-2-2-1-0-0
0-1-2-2-0-2-3-3-3-2-0-2-2-1-0
0-1-2-0-0-2-3-3-3-2-0-0-2-1-0
1-2-2-0-0-2-3-3-3-2-0-0-2-2-1
1-2-0-0-0-2-3-3-3-2-0-0-0-2-1
1-2-2-0-0-2-3-3-3-2-0-0-2-2-1
0-1-2-0-0-2-3-3-3-2-0-0-2-1-0
0-1-2-2-0-2-3-3-3-2-0-2-2-1-0
0-0-1-2-2-2-3-3-3-2-2-2-1-0-0
0-0-1-2-3-3-3-3-3-3-3-2-1-0-0
0-0-1-2-3-3-3-3-3-3-3-2-1-0-0
0-0-1-2-3-2-2-2-2-2-3-2-1-0-0
0-0-1-2-2-2-1-1-1-2-2-2-1-0-0
0-0-0-1-1-1-0-0-0-1-1-1-0-0-0