Fourth Room
41-42-43-44
0-0-0-4-4-4-0-0-0-0-0-0-0-3-3-0-0-0-0-0
0-0-0-4-3a-3a-3-0-0-0-0-0-0-2-3a-3-0-0-0-0
0-0-0-3-2a-1a-3-0-0-0-0-0-0-1-2a-4-4-0-0-0
0-4-4-1-1-2-1-3-3-3-0-0-4-2-2-1-4-0-0-0
0-3-2-2-1-1-2-1a-3a-3a-3-3-4-1-2-2-1-0-0-0
0-0-3-1-1-2-2-1-3a-3-4-2-2-1-1-2-2-4-0-0
0-4-3-3-1-1-2-2-1-3-4-1-2-1-3-3-2-1-4-4
0-4-3-1-2-2-2-0-0-0-1-1-2-3-3-3-3-2-1-4
0-3-3-2-2-1-1-0-0-0-1-1-1-2-1-3-3-3-4-0
4-3-2-1-1-2-1-2-1-2-2-1-2-1-2-1-3-2-4-0
4-1-1-2-1-2-1-1-2-2-2-2-1-2-1-1-1-1-2-4
0-0-2-1a-1-1-2-2-1-2-1-2-1-1-2-1-2a-1-2-3
0-0-4-2a-1-2-3-3-1-2-1-2-2-2-1-2-1a-1-3-3
0-0-4-4-2-3-3-3-2-1-1-2-0-0-2-1-3-3-3-4
0-0-4-4-3-3-2-3-3-1-1-2-0-0-0-3-3-3-4-0
0-0-0-4-3-2-1-3-3-2-2-1-0-0-0-3-3-4-0-0
0-0-0-0-2-1-1-1-3-3-1-2-2-2-1-2-3-4-0-0
0-0-0-0-0-0-3-3-3-3-3-4-2-1-1-2-4-0-0-0
0-0-0-0-0-0-0-0-0-0-0-4-4-4-4-0-0-0-0-0