Fifth Room
43-9
2-2-2-0-0-0-2-2-0-2-2-2-0-0-0-2
2-2-2-2-0-0-2-2-0-0-2-2-2-0-0-2
0-2-1-2-0-2-1-1-2-0-0-2-2-0-2-2
0-0-1-1-0-2-1-1-2-0-0-2-1-2-2-0
0-0-2-1-2-1-1-1-2-0-0-1-1-2-0-0
0-2-1-1-1-1-1-1-1-0-2-1-1-0-0-0
0-2-1-1-1-2-0-2-1-2-1-1-1-0-0-0
0-0-2-1-2-0-0-0-1-1-1-1-1-2-0-0
0-0-0-2-1-0-0-2-1-1-1-1-1-2-0-0
0-0-0-2-1-2-2-1-1-1-2-1-1-2-0-0
0-0-0-1-1-1-1-1-1-1-0-1-2-0-0-0
0-0-2-1-1-1-1-1-2-0-0-2-2-0-0-0
0-0-2-1-1-1-1-1-1-0-0-2-2-0-0-0
0-0-2-1-1-1-1-1-1-2-0-0-2-2-0-0
0-0-0-2-1-1-1-1-1-1-2-0-1-2-0-0
0-0-0-0-2a-1a-1-2-1-2a-2a-2-1-2-0-0
0-0-0-0-2-1-2-0-2-1-2-0-2-0-0-0
0-0-0-0-0-2-2-0-0-2-2-0-2-0-0-0
0-0-0-0-0-0-2-1a-2a-2a-2a-2a-2-0-0-0
0-0-0-0-0-0-0-2-1-2-0-0-2-0-0-0
0-0-0-0-0-0-0-0-2-2-0-0-0-0-0-0