Third Room
34-27-10
0-1-1-1-1-1-1-1-1-1-1-1-1-1-0-0-0-0-0
0-2-2a-1-2-1-1-1-1-1-2-2-1-1-0-0-0-0-0
0-2-1-2-2a-1-2-2-1-1-2-1-1-1-0-0-0-0-0
0-1-2a-2-1-2-1-2-2-1-2-2-1-1-0-0-0-0-0
0-2-2-1-2a-2-2-2-1-2-2-1-2-1-0-0-0-0-0
1-2-1a-1-1-2-2-1-2-1-2-2-2-1-1-1-1-1-1
1-1-1-1-2a-2-1-1-1-2-2-1-1-3-3-1-1-1-1
1-1-3a-1-1-3-1-1-2-2-1-1-3-1-3-3-1-1-1
1-1-3-3-1a-3-1-1-3-1-1-3-3-3-3-1-1-1-1
1-3-3-1-1-1-3-1-1-3-1-3-1-3-1-1-1-3-1
0-0-0-0-0-0-0-0-1-1-1-1-3-3-3-1-1-1-1