Second Room
6-7-8-9-10-11-12
0-0-0-0-0-0-0-0-1-1-2-1-0-0-0-0-0-0-0-0-0
0-0-0-1-1-2-2-1-3-3a-3a-3-2-0-0-0-0-0-0-0-0
0-0-3-3-3-3-3-3-3-3-3-3-1-2-2-1-0-0-0-0-0
0-3-3-3-5-6-4-3-3-3-3-3-3-3-3-3-3-3-0-0-0
2-3-3-3-0-0-5-3-3-3-3-3-3-3-3-3-3-3-1-2-0
2-1a-3-3-3-3-3-3-3-3-3-3-3-3-6-4-3-3-2-2-0
1-2a-3-3-3-3-3-3-3-3-3-3-5-3-3-3-3-3-3-3-1
1-3-3-3-6-5-4-3-3-3-4-5-4-6-3-3-3-3-3-3-1
0-3-3-3-0-0-6-3-3-6-0-0-3-3-3-3-3-3-3-3-2
0-0-3-3-3-3-3-3-3-3-3-3-3-3-3-3-3-3-3-1-0
0-0-0-3-3-3-3-3-3-3-3-3-3-5-4-3-3-3-2-0-0
0-0-0-0-0-0-0-3-3-3-3-3-3-3-3-3-1-2-0-0-0
0-0-0-0-0-0-0-0-1-2-3-3-3-3-3-2-0-0-0-0-0
0-0-0-0-0-0-0-0-0-0-2-2a-3a-3-3-1-0-0-0-0-0
0-0-0-0-0-0-0-0-0-0-1-1-3-3-3-0-0-0-0-0-0
0-0-0-0-0-0-0-0-0-0-0-2-1-1-0-0-0-0-0-0-0