Final Room
8-3-32
2-2-2-2-2-0-0-2-2-2-2-2-0-0-2-2-2-2-2
2-1-1-1-1-2-2-1-1-1-1-1-2-2-1-1-1-1-2
2-1-3-1-1-1-1-1-1-1-1-1-1-1-1-1-3-1-2
2-1-3-1-1-0-0-1-1-1-1-1-0-0-1-1-3-1-2
2-1-3-1-1-0-1-1-1-1-1-1-1-0-1-1-3-1-2
2-1-1-3-1-0-1-1a-1a-3-1a-1a-1-0-1-3-1-1-2
2-1-1-1-3-1-1-1a-1-3-1-1a-1-1-3-1-1-1-2
2-1-1-1-3-1-1-1-3-0-3-1-1-1-3-1-1-1-2
2-1-1-1-3-1-3-3-0-0-0-3-3-1-3-1-1-1-2
2-1-1-1-3-1-1-1-3-0-3-1-1-1-3-1-1-1-2
2-1-1-1-3-1-1-1a-1-3-1-1a-1-1-3-1-1-1-2
2-1-1-3-1-0-1-1a-1a-3-1a-1a-1-0-1-3-1-1-2
2-1-3-1-1-0-1-1-1-1-1-1-1-0-1-1-3-1-2
2-1-3-1-1-0-0-1-1-1-1-1-0-0-1-1-3-1-2
2-1-3-1-1-1-1-1-1-1-1-1-1-1-1-1-3-1-2
2-1-1-1-1-2-2-1-1-1-1-1-2-2-1-1-1-1-2
2-2-2-2-2-0-0-2-2-2-2-2-0-0-2-2-2-2-2