Final Room
13-14
0-0-0-0-0-0-0-0-1-1-1-1-1-0-0-0-0-0-0
0-0-0-0-0-0-0-1-1-2-2-1-1-0-0-0-0-0-0
0-0-0-0-0-0-1-1-2-1-1-1-0-0-0-0-0-0-0
0-0-0-0-0-1-1-1-1-1-1-1-0-0-0-0-0-0-0
0-0-0-0-1-1-1-1-1-1-1-1-0-0-0-0-0-0-0
0-0-0-1-1-1-1-1-1-1-1-2-1-0-0-0-0-0-0
0-0-1-2-1-1-1-1-1-2-2-1-1-0-0-0-0-0-0
0-1-2-1-1-1-1-2-2-2-1-1-1-0-0-0-0-0-0
1-1-1-1-1-2-2-2-2-2-1-1-1-0-0-0-0-0-0
1-1-1-1a-2-2-2-2a-2-1-1-1a-1-1-0-0-0-0-0
1-1-1-1a-1-2-2-2a-2-2-1-1a-1-1-1-0-0-0-0
0-0-1-1-1-1-1-2-2-2-2-1-1-1-1-1-0-0-0
0-0-0-0-1-1-1-1-1-2-2-2-1-1-1-1-1-0-0
0-0-0-0-0-0-1-1-1-1-1-2-2-1-1-2-1-1-0
0-0-0-0-0-0-0-1-1-1-1-1-2-1-1-1-2-1-1
0-0-0-0-0-0-0-0-1-1-1-1-1-2-1-1-1-1-1
0-0-0-0-0-0-0-0-1-1-1-1-1-1-1-1-1-0-0
0-0-0-0-0-0-0-0-0-1-1-1-1-1-1-0-0-0-0
0-0-0-0-0-0-0-0-0-0-1-1-1-0-0-0-0-0-0