Fourth Room
15-16
0-0-2-2-2-2-2-2-2-2-2-2-2-2-2-2-0-0-0
0-2-1-1-1-1-1-1-1-1-1-1-1-1-1-1-2-0-0
0-2-1-1-2-2-2-2-1-1-1-1a-1a-1a-1-1-1-2-0
2-1-1-2-0-0-0-0-2-1-1-1a-1a-1a-1-1-1-2-0
2-1-1-1-2-2-2-2-1-1-1-1-1-1-1-1-1-1-2
2-1-1-1-1-1-1-1-1-1-1-1-1-2-2-2-1-1-2
2-1-1-1-1-1-1-1-1-1-1-1-2-0-0-0-2-1-2
2-1-1-1-1-1-1-1-1-1-1-1-1-2-2-2-1-1-2
0-2-2-1-1-1-1-1-1-1-1-1-1-1-1-1-1-2-0
0-0-0-2-1-1-1-1-1-1-1-1-1-1-1-1-1-2-0
0-0-0-0-2-2-2-2-2-2-2-2-2-2-2-2-2-0-0