Fourth Room
17-18-19-20-21-22
0-0-0-0-0-0-0-0-6-6-0-0-0-6-6-0-0-0-0
0-0-0-0-0-6-6-6-2-2-6-6-6-2-2-6-0-0-0
0-0-0-0-6-2-2-2-3-4-2-2-2-4-3-2-6-0-0
0-0-0-6-2-3-4-4-4-3-1-4-3-3-4-4-2-6-0
0-0-0-6-2-4-3-4-3-3-1-1-4-3-3-4-2-6-0
0-0-6-2-4-3-4-4-1-1a-1a-5-1-1-1-3-4-2-6
0-0-6-2-3-4-3-1-1a-1a-5a-1a-5-1-1-1-3-2-6
0-0-6-2-3-1-1-1-5-5a-5a-1-1-5-1-1-4-2-6
0-6-2-4-3-3-1-1-1-1-5-5-1-1-4-3-2-6-0
6-2-3-3-4-4-4-3-1-5-1-1-1-3-4-2-6-0-0
6-2-4-3-3-4-3-4-4-1-4-4-4-3-2-6-0-0-0
0-6-2-3-4-4-3-2-2-2-2-2-3-4-2-6-0-0-0
0-0-6-2-2-2-2-6-6-6-6-6-2-2-6-0-0-0-0
0-0-0-6-6-6-6-0-0-0-0-0-6-6-0-0-0-0-0