Fourth Room
23-24-25
0-0-0-0-1-1-1-1-1-1-1-1-1-1-1-1-1-1-1-1-0-0-0-0
0-0-1-1-1-1a-1-1-1-1-1-1-1-1-1-1-1-1-1a-1-1-1-0-0
1-1-1-1-1-1-1-1-1-1-1-1-1-1-1-1-1-1-3-2-1-1-1-1
1-1-1-1-1-1-1-1-1-1-1-1-1-1-1-1-1-1-1-1-1-3-1-1
1-1-1-1-1-1-1-1-1-1-1-1-1-1-1-1-3-2-1-3-2-1-1-1
0-1-1-1-1-1-1-1-1-1-1-1-1-3-2-2-1-3-2-2-1-1-1-0
0-0-1-1a-1-1-1-1-1-1-1-2-3-1-1-1-1-1-1-1-1a-1-0-0
0-1-1-1-1-1-1-1-1-1-2-1-2-1-1-1-1-1-1-1-1-1-1-0
1-1-1-1-1-2-1-1-3-2-1-1-1-1-1-1-1-1-1-1-1-1-1-1
1-1-1-1-1-3-3-2-1-3-1-1-1-1-1-1-1-1-1-1-1-1-1-1
1-1-2-1-2-2-1-1-1-1-1-1-1-1-1-1-1-1-1-1-1-1-1-1
0-0-1-1-1-1a-1-3-2-1-1-1-1-1-1-1-1-1-1a-1-1-1-0-0
0-0-0-0-1-1-1-1-1-1-1-1-1-1-1-1-1-1-1-1-0-0-0-0