Crockrarock
5-8-10
1-1-1-0-0-0-0-0-1-1-1
1-2a-1a-1-3-3-3-1-1b-2b-1
1-1a-1a-1-1-1-1-1-1b-1b-1
0-1-1-1-1-1-1-1-1-1-0
0-3-1a-1-0-0-0-1-1b-3-0
0-3-1a-1-0-0-0-1-1b-3-0
0-3-1a-1-0-0-0-1-1b-3-0
0-1-1-1-1-1-1-1-1-1-0
1-1a-1a-1-1-1-1-1-1b-1b-1
1-2a-1a-1-3-3-3-1-1b-2b-1
1-1-1-0-0-0-0-0-1-1-1