Arena II
13-14-17-18
0-0-0-4-1-2-1-1-1-1-1-4-0-0-0
0-3-1-4-3-1-1-0-1-2-1-4-3-1-0
1-1-2-1-0-1-1-1-3-1-0-1-1-1-3
1-1-1-1-0-1-2-1-1-1-0-1-2-1-1
1-1-4-0-0-1-1-0-1-1-0-0-4-1-2
2-1-1-1-1-3-1-1-1-1-1-3-1-1-1
1-1-2-1-1-0-1-2-1-0-1-1-1-1-1
1-1-1-1-3-1-1-1-1-3-1-1-1-2-1
1-2-4-0-0-1-1-0-1-1-0-0-4-1-1
3-1-1-1-0-1-2-1-1-1-0-1-1-1-3
1-1-2-1-0-1-1-1-3-1-0-1-2-1-1
0-1-1-4-3-1-1-0-1-1-1-4-1-1-0
0-0-0-4-1-2-1-1-1-3-1-4-0-0-0