Abraknide
9-10-11-12
2-1-1-3-1-1-0-0-0-0-1-1-1-3-1-2
2-3-1-1-4a-4a-4a-4a-4a-4a-4a-4a-1-2-1-2
1-1-0-1-1-4a-4a-4a-4a-4a-4a-1-1-0-1-1
1-1-0-2-1-1-0-1-1-0-1-1-2-0-3-1
1-1-3-1-1-1-0-1-1-0-1-1-1-1-1-1
1-4a-1-1-1-3-1-1-1-2-1-1-1-1-4a-1
1-1-1-0-3-3-1-1-1-1-3-3-0-2-1-1
0-1-1-3-1-1-1-2-2-1-1-1-3-1-1-0
0-1-2-3-1-1-2-3-3-2-1-1-3-2-1-0
0-1-2-3-1-1-2-3-3-2-1-1-3-2-1-0
0-1-1-3-1-1-1-2-2-1-1-1-3-1-1-0
1-1-1-0-3-3-1-1-1-1-3-3-0-1-1-1
1-4b-1-1-1-2-1-1-1-2-1-1-1-1-4b-1
1-1-1-1-1-1-0-1-1-0-1-1-1-1-3-1
1-3-0-2-1-1-0-1-1-0-1-1-2-0-1-1
1-1-0-1-1-4b-4b-4b-4b-4b-4b-3-1-0-1-1
2-1-1-1-4b-4b-4b-4b-4b-4b-4b-4b-1-1-1-2
2-1-1-3-1-1-0-0-0-0-3-1-1-3-1-2