Gelaglax
29-30-31-32-33
1-1-1-1-1-1-1-1-0-0-0-0-0-0-0-0-0-0-0
1-5-5-5-5-5-5-1-0-0-0-0-0-0-0-0-0-0-0
1-5-5a-5a-5a-5a-5-1-0-0-0-0-0-0-0-0-0-0-0
1-5-5a-5a-5a-5a-5-1-0-0-0-0-0-0-0-0-0-0-0
1-5-5-5-5-5-5-1-0-0-0-2-2-2-2-2-2-2-2
1-5-5-5-5-5-5-1-4-4-4-2-5-5-5-5-5-5-2
1-5-5-5-5-5-5-1-4-4-4-2-5-5-5-5-5-5-2
1-1-1-1-1-1-1-1-0-0-0-2-5-5-5a-5a-5-5-2
0-0-0-0-0-0-0-0-0-0-0-2-5-5-5-5-5-5-2
2-2-2-2-2-2-2-2-0-0-0-2-5-5-5a-5a-5-5-2
2-5-5-5-5-5-5-2-4-4-4-2-5-5-5-5-5-5-2
2-5-5-5-5-5-5-2-4-4-4-2-5-5-5-5-5-5-2
2-5-5-5b-5b-5-5-2-0-0-0-2-2-2-2-2-2-2-2
2-5-5-5-5-5-5-2-0-0-0-0-0-0-0-0-0-0-0
2-5-5-5b-5b-5-5-2-0-0-0-3-3-3-3-3-3-3-3
2-5-5-5-5-5-5-2-4-4-4-3-5-5-5-5-5-5-3
2-5-5-5-5-5-5-2-4-4-4-3-5-5-5-5-5-5-3
2-2-2-2-2-2-2-2-0-0-0-3-5-5-5-5-5-5-3
0-0-0-0-0-0-0-0-0-0-0-3-5-5b-5b-5b-5b-5-3
0-0-0-0-0-0-0-0-0-0-0-3-5-5b-5b-5b-5b-5-3
0-0-0-0-0-0-0-0-0-0-0-3-5-5-5-5-5-5-3
0-0-0-0-0-0-0-0-0-0-0-3-3-3-3-3-3-3-3